6
B B B S W 0
0 0 W 0 W B
P 0 T T 0 B
S S T 0 T W
0 0 0 0 0 0
T B B 0 0 S