13
0 0 0 0 0 0 0 0 0 0 0 0 0
0 S S 0 0 0 0 0 0 0 S S 0
0 S S 0 0 0 0 0 0 0 S S 0
0 0 0 0 0 B B B 0 0 0 0 0
0 0 0 0 0 0 0 0 0 0 0 0 0
0 0 0 B 0 T T T 0 B 0 0 0
0 0 0 B 0 T T T 0 B 0 0 0
0 0 0 B 0 T T T 0 B 0 0 0
0 0 0 0 0 0 0 0 0 0 0 0 0
0 0 0 0 0 B B B 0 0 0 0 0
0 S S 0 0 0 0 0 0 0 S S 0
0 S S 0 0 0 0 0 0 0 S S 0
0 0 0 0 0 0 P 0 0 0 0 0 0